"filename", "language", "Rust", "Markdown", "YAML", "comment", "blank", "total"
"d:\code\Rust crate\anyhow-master\.github\workflows\ci.yml", "YAML", 0, 0, 72, 0, 8, 80
"d:\code\Rust crate\anyhow-master\README.md", "Markdown", 0, 134, 0, 0, 49, 183
"d:\code\Rust crate\anyhow-master\build.rs", "Rust", 90, 0, 0, 6, 18, 114
"d:\code\Rust crate\anyhow-master\src\backtrace.rs", "Rust", 332, 0, 0, 19, 51, 402
"d:\code\Rust crate\anyhow-master\src\chain.rs", "Rust", 91, 0, 0, 0, 12, 103
"d:\code\Rust crate\anyhow-master\src\context.rs", "Rust", 136, 0, 0, 20, 22, 178
"d:\code\Rust crate\anyhow-master\src\ensure.rs", "Rust", 615, 0, 0, 17, 187, 819
"d:\code\Rust crate\anyhow-master\src\error.rs", "Rust", 596, 0, 0, 290, 82, 968
"d:\code\Rust crate\anyhow-master\src\fmt.rs", "Rust", 128, 0, 0, 3, 25, 156
"d:\code\Rust crate\anyhow-master\src\kind.rs", "Rust", 57, 0, 0, 45, 15, 117
"d:\code\Rust crate\anyhow-master\src\lib.rs", "Rust", 101, 0, 0, 545, 21, 667
"d:\code\Rust crate\anyhow-master\src\macros.rs", "Rust", 87, 0, 0, 132, 5, 224
"d:\code\Rust crate\anyhow-master\src\ptr.rs", "Rust", 168, 0, 0, 1, 31, 200
"d:\code\Rust crate\anyhow-master\src\wrapper.rs", "Rust", 65, 0, 0, 0, 14, 79
"d:\code\Rust crate\anyhow-master\tests\common\mod.rs", "Rust", 11, 0, 0, 0, 4, 15
"d:\code\Rust crate\anyhow-master\tests\compiletest.rs", "Rust", 6, 0, 0, 2, 0, 8
"d:\code\Rust crate\anyhow-master\tests\drop\mod.rs", "Rust", 44, 0, 0, 0, 10, 54
"d:\code\Rust crate\anyhow-master\tests\test_autotrait.rs", "Rust", 11, 0, 0, 0, 3, 14
"d:\code\Rust crate\anyhow-master\tests\test_backtrace.rs", "Rust", 11, 0, 0, 0, 3, 14
"d:\code\Rust crate\anyhow-master\tests\test_boxed.rs", "Rust", 39, 0, 0, 1, 6, 46
"d:\code\Rust crate\anyhow-master\tests\test_chain.rs", "Rust", 62, 0, 0, 0, 7, 69
"d:\code\Rust crate\anyhow-master\tests\test_context.rs", "Rust", 133, 0, 0, 4, 36, 173
"d:\code\Rust crate\anyhow-master\tests\test_convert.rs", "Rust", 40, 0, 0, 0, 7, 47
"d:\code\Rust crate\anyhow-master\tests\test_downcast.rs", "Rust", 110, 0, 0, 0, 14, 124
"d:\code\Rust crate\anyhow-master\tests\test_ensure.rs", "Rust", 560, 0, 0, 16, 110, 686
"d:\code\Rust crate\anyhow-master\tests\test_ffi.rs", "Rust", 14, 0, 0, 0, 5, 19
"d:\code\Rust crate\anyhow-master\tests\test_fmt.rs", "Rust", 76, 0, 0, 0, 19, 95
"d:\code\Rust crate\anyhow-master\tests\test_macros.rs", "Rust", 63, 0, 0, 4, 13, 80
"d:\code\Rust crate\anyhow-master\tests\test_repr.rs", "Rust", 24, 0, 0, 0, 6, 30
"d:\code\Rust crate\anyhow-master\tests\test_source.rs", "Rust", 53, 0, 0, 0, 10, 63
"d:\code\Rust crate\anyhow-master\tests\ui\chained-comparison.rs", "Rust", 5, 0, 0, 2, 2, 9
"d:\code\Rust crate\anyhow-master\tests\ui\empty-ensure.rs", "Rust", 5, 0, 0, 0, 2, 7
"d:\code\Rust crate\anyhow-master\tests\ui\no-impl.rs", "Rust", 6, 0, 0, 0, 3, 9
"d:\code\Rust crate\anyhow-master\tests\ui\temporary-value.rs", "Rust", 4, 0, 0, 0, 2, 6
"d:\code\Rust crate\anyhow-master\tests\ui\wrong-interpolation.rs", "Rust", 4, 0, 0, 0, 2, 6
"Total", "-", 3747, 134, 72, 1107, 804, 5864